1111011111111111
0000000000010101
0101111101010001
0100010001010101
0111010101000100
0010010111010111
1110110101010101
1011010100010001
1000000111011111